  
R 1050 800
NO texture/north.xpm  
SO      texture/south.xpm  
WE          texture/west.xpm  
EA                 texture/east.xpm  

S     texture/sprite.xpm 

F 87,58,24
C 111,74,29



        1111111111111111111111111
        1000000000110000000000001
        1011000001110000002000001
        1001000000000000000000001
111111111011000001110E00000020001
100000000110000011101110111111111
11110111111111011100000010001
11110111111111011101010010001
11000000110101011100000010001
10002000000000001100000010001
10000000002000001111010010001
1100000111010101111101111100111
11110111 1110101 10111110001
11111111 1111111 11111111111