  
R 1150 500
NO texture/north.xpm  
SO      texture/test.xpm  
WE          texture/test.xpm  
EA                 texture/test.xpm  

S     texture/test.xpm  

F 220,100,0
C 255,30,00



        1111111111111111111111111
        10E0000000110000000000001
        1011000001110000002000001
        1001000000000000000000001
111111111011000001110000000000001
100000000110000011101111111111111
11110111111111011100000010001
11110111111111011101010010001
11000000110101011100000010001
10002000000000001100000010001
10000000000000001101010010001
1100000111010101111101111100111
11110111 1110101 10111110001
11111111 1111111 11111111111