
R 450 369
NO texture/brick.xpm  
SO      texture/wall.xpm  
WE          texture/west.xpm  
EA                 texture/east.xpm  

S     texture/sprite.xpm 

F 87,58,24
C 111,74,29

             1
            1011111
           100200001
          1000000001
          101100001
           101000001
           10000001
           10111101 11
           1001 1001001
    11   11100010100001
 111001 100000010110001
1001001100000100010001
1000001100000000000001
100010000001100000001
1001 111101 1000000001
1001    10110101000001
10001  100010000000001
1001  1000000000000011
 101  10000000000000001
  1   10000000000000001
     11000000000000000111   111
    1000000010000000001001110001
 11100000000000000000000000000001
100000000000001111110000000100001
 10000001001011   10000000100001
  11111000000001 10000000000011
      101000000011000000000001
  11  100001100001000000020001
 10011110001101000000000000011
1000000100000010000000000000001 11
10000100000000001100000000000011001
 100000000200000011000000000000001
  1100000000000000000000001100011
    1110000000000000000001  1001
       100000000000000001  1001
        1000000002000001    11
       10000000000000001
      10000010000100011
     10000111111111101
  1  10000000000000001 111
 10110000000000000111 10001
10000000000000000000110001
10000000000000000000000001
100000000000000000000000001
 100000100000000000000000001
 1000000000000000000000110111
 10010000100000000121001000001  1
 100110000000000000110000000001101
1001100011111000000000000000000001
100011101   100000000000101000001
100001 1     1000000000010100001
1000001    111011000001000100001
100100011 100001100201 111000001
100100000100000000111    100011
100000000000000001       1001
100100011111001001       1001
10010001    101001        11
 11 10001   10001    1
   1000001111011    101
   100000000101   11001
 1 10100000011   100001
101000000001     100001111
1000000000011     100010001
10000000000001   1000010001      1
1000000200000011111000000111  11101
10000000000000000000011000001100N01
100000000000000000001 110000000111
10010100000010000011 10100001101
120001111111000001  100000001 1
100001    100000011110010001111
10001    10000000000010100100001
10001  1100100000000020000000001
10001110000000010000000100001001
1001101000000000000000001111 11
1000001000000001100100001
1000000000000001 11 100001
10001000000000001    1001
10000000000000001     11
1000000000000011
100000000000001111
1000000000000000001
1000000000000000001
10000000000000000001
10000000000000000001
 100000000001000000111
 1100100000000000001001
100000000000000000000001111
1001110000000000000000000001
10110000000000000000000000001
1000010000000000000011000001
 11111000010000000001 10001
      100000000000000110101
      10000000110100000011
       1111111  1 111111
