R 400 400
NO texture/brick.xpm  
SO      texture/wall.xpm  
WE          texture/west.xpm  
EA                 texture/east.xpm  

S     texture/sprite.xpm 

F 87,58,24
C  255,74,250

111111
122221
122211
1221N1
111111