R 200 300
NO texture/brick.xpm  
SO      texture/wall.xpm  
WE          texture/west.xpm  
EA                 texture/east.xpm  

S     texture/sprite.xpm 

F 87,58,24
C  255,74,250

111111
122221
122221
1222N1
111111