R 700 306
NO texture/brick.xpm  
SO      texture/wall.xpm  
WE          texture/west.xpm  
EA                 texture/east.xpm  

S     texture/bonhome.xpm 

F 87,58,24
C 111,74,29

111111
122221
122221
1222N1
111111